{
    “##################"
"# ## #"
"# ~빼 #뼈# #"
“# # ## ## # #"
"11 11 M # 11"
"# #11#11##### 11"
"# # # # # #"
"# # m m # #"
"# # # #"
"# # ## # #"
"##################"
}